WMU,Year,Active Hunters,Bull Harvest,Cow Harvest,Calf Harvest,Total Harvest
2,2006,309,35,16,9,60
2,2007,402,35,11,36,82
2,2008,349,29,12,11,52
2,2009,311,25,10,11,46
2,2010,380,31,10,5,46
2,2011,417,21,8,13,42
2,2012,297,17,12,7,36
2,2013,274,18,20,12,50
2,2014,289,21,14,8,43
2,2015,306,18,20,7,45
2,2016,281,13,11,2,26
2,2017,280,24,10,0,34
2,2018,334,19,7,2,28
2,2019,272,18,4,3,25
2,2020,329,24,15,2,41
2,2021,325,22,11,7,40
2,2022,324,29,8,2,39
2,2023,294,28,12,2,42
3,2006,1375,145,49,77,271
3,2007,1404,132,44,58,234
3,2008,1380,123,46,76,245
3,2009,1427,88,50,63,201
3,2010,1457,86,53,61,200
3,2011,1406,88,45,35,168
3,2012,1337,93,70,48,211
3,2013,1300,66,65,59,190
3,2014,1169,60,43,38,141
3,2015,1084,50,32,6,88
3,2016,1082,60,42,10,112
3,2017,1072,42,44,19,105
3,2018,1114,39,28,12,79
3,2019,1095,72,50,7,129
3,2020,1123,62,39,2,103
3,2021,881,67,43,16,126
3,2022,789,47,46,13,106
3,2023,788,55,46,12,113
4,2006,1044,117,42,20,179
4,2007,939,120,38,24,182
4,2008,903,90,24,27,141
4,2009,1049,63,22,9,94
4,2010,922,66,32,20,118
4,2011,922,73,33,39,145
4,2012,931,77,43,23,143
4,2013,990,88,47,30,165
4,2014,946,59,45,39,143
4,2015,840,37,33,6,76
4,2016,806,56,39,19,114
4,2017,881,53,43,3,99
4,2018,954,23,48,3,74
4,2019,878,51,45,9,105
4,2020,1000,55,45,0,100
4,2021,716,66,47,16,129
4,2022,721,63,37,15,115
4,2023,725,53,46,13,112
5,2006,2725,209,83,85,377
5,2007,2480,218,75,126,419
5,2008,2418,201,62,78,341
5,2009,2550,184,61,90,335
5,2010,2053,139,58,60,257
5,2011,1977,131,62,102,295
5,2012,2026,150,63,81,294
5,2013,1932,141,61,103,305
5,2014,1244,28,35,30,93
5,2015,943,40,24,24,88
5,2016,794,29,27,25,81
5,2017,840,25,20,11,56
5,2018,830,16,30,8,54
5,2019,937,30,43,7,80
5,2020,990,34,44,10,88
5,2021,632,46,37,13,96
5,2022,601,43,39,9,91
5,2023,593,34,28,13,75
6,2006,580,44,17,13,74
6,2007,349,22,6,4,32
6,2008,275,14,4,2,20
6,2009,310,4,0,0,4
6,2010,271,6,3,0,9
6,2011,169,7,0,2,9
6,2012,155,5,0,3,8
6,2013,148,9,0,0,9
6,2014,96,0,0,0,0
6,2015,67,6,0,0,6
6,2016,22,0,0,0,0
6,2017,21,0,0,0,0
6,2018,31,0,0,0,0
6,2019,32,0,0,0,0
6,2020,29,0,0,0,0
6,2021,3,0,0,0,0
6,2022,13,0,0,1,1
6,2023,16,0,0,1,1
8,2006,1398,123,51,44,218
8,2007,1485,97,37,32,166
8,2008,1184,98,38,30,166
8,2009,1261,63,25,22,110
8,2010,1145,62,24,37,123
8,2011,975,53,44,10,107
8,2012,809,48,26,15,89
8,2013,772,35,17,0,52
8,2014,411,5,7,0,12
8,2015,238,2,7,4,13
8,2016,121,6,4,0,10
8,2017,187,3,6,3,12
8,2018,198,5,5,2,12
8,2019,195,5,0,1,6
8,2020,184,5,1,1,7
8,2021,62,2,2,2,6
8,2022,53,4,1,5,10
8,2023,43,5,2,5,12
13,2006,5017,307,131,169,607
13,2007,4751,279,126,80,485
13,2008,4121,219,80,50,349
13,2009,4196,180,94,86,360
13,2010,3765,208,134,104,446
13,2011,3763,189,96,87,372
13,2012,3578,209,90,50,349
13,2013,3637,177,74,95,346
13,2014,1631,21,13,24,58
13,2015,1074,20,16,10,46
13,2016,1051,26,24,0,50
13,2017,1075,25,25,14,64
13,2018,908,15,11,21,47
13,2019,791,10,14,13,37
13,2020,765,11,11,6,28
13,2021,247,17,11,4,32
13,2022,181,9,7,0,16
13,2023,147,8,5,7,20
14,2006,212,17,2,8,27
14,2007,179,13,2,8,23
14,2008,143,15,3,6,24
14,2009,165,6,4,17,27
14,2010,145,19,3,6,28
14,2011,197,22,15,8,45
14,2012,188,15,19,6,40
14,2013,245,15,9,11,35
14,2014,250,13,13,13,39
14,2015,153,8,10,4,22
14,2016,195,8,12,5,25
14,2017,197,13,14,0,27
14,2018,152,11,9,2,22
14,2019,146,12,7,4,23
14,2020,174,7,6,1,14
14,2021,139,10,6,5,21
14,2022,140,10,8,1,19
14,2023,149,12,7,4,23
17,2006,265,13,9,7,29
17,2007,309,36,13,9,58
17,2008,324,29,8,4,41
17,2009,318,15,5,8,28
17,2010,333,32,17,14,63
17,2011,319,35,17,2,54
17,2012,302,35,7,0,42
17,2013,301,29,10,10,49
17,2014,384,26,6,7,39
17,2015,410,33,7,0,40
17,2016,439,40,20,0,60
17,2017,466,23,5,0,28
17,2018,420,25,7,0,32
17,2019,412,21,11,0,32
17,2020,496,17,11,1,29
17,2021,508,18,7,4,29
17,2022,391,21,3,0,24
17,2023,325,13,6,1,20
19,2006,1233,50,18,24,92
19,2007,1226,64,20,25,109
19,2008,1354,47,21,12,80
19,2009,1425,40,12,0,52
19,2010,1647,54,27,33,114
19,2011,1498,66,37,0,103
19,2012,1540,58,23,11,92
19,2013,1461,52,16,2,70
19,2014,1630,63,20,9,92
19,2015,1402,52,15,7,74
19,2016,1517,46,17,3,66
19,2017,1573,37,27,3,67
19,2018,1538,23,20,3,46
19,2019,1444,48,16,8,72
19,2020,1612,54,21,0,75
19,2021,1419,43,20,12,75
19,2022,1265,43,21,4,68
19,2023,1300,42,24,4,70
22,2006,1246,76,24,39,139
22,2007,959,26,11,16,53
22,2008,832,29,10,2,41
22,2009,792,36,13,15,64
22,2010,824,26,6,14,46
22,2011,971,46,32,17,95
22,2012,900,49,24,21,94
22,2013,1104,57,29,13,99
22,2014,1183,45,25,23,93
22,2015,943,19,29,0,48
22,2016,767,15,29,0,44
22,2017,885,21,35,14,70
22,2018,939,17,19,32,68
22,2019,888,24,30,4,58
22,2020,793,22,13,1,36
22,2021,483,25,15,8,48
22,2022,443,13,15,7,35
22,2023,411,14,17,7,38
23,2006,828,27,13,8,48
23,2007,881,41,12,9,62
23,2008,900,28,11,2,41
23,2009,1241,62,37,18,117
23,2010,1290,60,33,13,106
23,2011,1192,71,28,18,117
23,2012,1249,66,27,0,93
23,2013,1363,44,16,16,76
23,2014,1107,16,23,12,51
23,2015,997,40,11,3,54
23,2016,969,31,22,7,60
23,2017,1047,36,34,3,73
23,2018,1178,37,18,0,55
23,2019,1166,36,29,11,76
23,2020,1173,40,23,4,67
23,2021,840,30,22,6,58
23,2022,730,34,22,5,61
23,2023,785,49,23,6,78
24,2006,1954,92,53,24,169
24,2007,2077,84,59,13,156
24,2008,2066,88,49,38,175
24,2009,1964,85,40,62,187
24,2010,1916,92,48,71,211
24,2011,1814,111,62,41,214
24,2012,1999,91,48,43,182
24,2013,1988,63,40,0,103
24,2014,2159,67,28,27,122
24,2015,2064,69,33,0,102
24,2016,1799,57,37,42,136
24,2017,1977,63,51,12,126
24,2018,1964,47,31,41,119
24,2019,2122,85,63,7,155
24,2020,2123,83,39,11,133
24,2021,1588,75,54,19,148
24,2022,1472,92,39,23,154
24,2023,859,34,25,12,71
25,2006,288,14,4,2,20
25,2007,331,19,11,4,34
25,2008,329,15,7,0,22
25,2009,329,25,4,3,32
25,2010,385,29,5,0,34
25,2011,381,17,10,8,35
25,2012,300,15,9,3,27
25,2013,308,8,6,5,19
25,2014,394,20,11,6,37
25,2015,311,6,7,0,13
25,2016,277,12,2,1,15
25,2017,269,16,6,2,24
25,2018,247,14,0,2,16
25,2019,265,11,6,0,17
25,2020,251,15,3,0,18
25,2021,202,11,1,0,12
25,2022,177,12,4,1,17
25,2023,203,9,1,1,11
26,2006,715,16,8,5,29
26,2007,679,20,7,5,32
26,2008,579,22,8,9,39
26,2009,606,16,5,8,29
26,2010,673,27,8,11,46
26,2011,676,16,10,6,32
26,2012,737,16,5,19,40
26,2013,643,11,5,6,22
26,2014,765,23,7,14,44
26,2015,814,25,7,0,32
26,2016,731,15,7,0,22
26,2017,794,14,3,0,17
26,2018,694,14,3,2,19
26,2019,468,4,1,3,8
26,2020,466,11,3,3,17
26,2021,393,13,6,2,21
26,2022,315,1,9,2,12
26,2023,318,13,6,4,23
27,2006,1322,54,15,33,102
27,2007,1339,45,10,54,109
27,2008,1244,37,9,14,60
27,2009,1272,42,4,14,60
27,2010,1256,37,4,23,64
27,2011,1174,33,14,19,66
27,2012,1174,33,8,25,66
27,2013,1284,43,14,25,82
27,2014,1284,27,18,18,63
27,2015,921,27,10,0,37
27,2016,1255,52,35,24,111
27,2017,1319,40,30,14,84
27,2018,1374,27,30,0,57
27,2019,1402,44,27,13,84
27,2020,1409,39,33,10,82
27,2021,1119,51,43,19,113
27,2022,1194,31,36,22,89
27,2023,674,21,12,2,35
28,2006,5133,207,81,113,401
28,2007,5301,150,81,111,342
28,2008,4897,70,70,63,203
28,2009,5065,89,124,120,333
28,2010,5242,162,124,125,411
28,2011,5260,146,101,88,335
28,2012,5268,110,92,58,260
28,2013,5326,127,91,80,298
28,2014,3404,10,11,59,80
28,2015,1982,11,3,46,60
28,2016,1763,15,5,50,70
28,2017,2297,32,15,32,79
28,2018,2425,34,39,38,111
28,2019,2631,61,38,57,156
28,2020,2712,46,37,46,129
28,2021,2158,87,69,42,198
28,2022,2224,89,55,38,182
28,2023,2207,80,47,39,166
29,2006,2832,54,32,54,140
29,2007,2742,50,29,37,116
29,2008,2842,45,28,36,109
29,2009,2843,47,31,50,128
29,2010,2680,48,41,63,152
29,2011,2803,39,31,36,106
29,2012,2740,34,25,25,84
29,2013,2789,29,36,35,100
29,2014,2741,29,27,30,86
29,2015,1883,27,18,11,56
29,2016,1328,6,8,15,29
29,2017,1168,6,3,21,30
29,2018,1263,3,2,17,22
29,2019,1370,14,8,21,43
29,2020,1350,9,14,12,35
29,2021,806,20,22,22,64
29,2022,767,18,21,7,46
29,2023,721,16,19,16,51
30,2006,2048,63,37,22,122
30,2007,1892,51,30,57,138
30,2008,1909,54,18,8,80
30,2009,1909,54,33,23,110
30,2010,2048,78,27,49,154
30,2011,2041,65,34,36,135
30,2012,1952,47,38,8,93
30,2013,2030,52,35,24,111
30,2014,2082,44,25,38,107
30,2015,1053,7,6,14,27
30,2016,797,0,6,3,9
30,2017,849,7,2,17,26
30,2018,904,6,5,16,27
30,2019,979,9,6,16,31
30,2020,859,7,7,13,27
30,2021,284,13,0,7,20
30,2022,265,13,4,5,22
30,2023,716,51,21,12,84
31,2006,1724,35,8,29,72
31,2007,1742,40,16,23,79
31,2008,1753,29,12,20,61
31,2009,1510,16,5,10,31
31,2010,1388,18,10,24,52
31,2011,1339,12,2,11,25
31,2012,1400,23,13,34,70
31,2013,1489,17,9,10,36
31,2014,1420,10,10,24,44
31,2015,1030,20,14,9,43
31,2016,818,21,10,18,49
31,2017,1102,16,5,25,46
31,2018,1042,13,10,11,34
31,2019,895,4,8,14,26
31,2020,1126,29,14,10,53
31,2021,947,38,24,17,79
31,2022,936,38,21,16,75
31,2023,966,35,20,18,73
32,2006,1398,63,42,46,151
32,2007,1239,59,14,35,108
32,2008,1127,47,12,16,75
32,2009,1075,29,15,7,51
32,2010,999,26,11,14,51
32,2011,1082,25,3,16,44
32,2012,936,7,14,39,60
32,2013,836,24,12,6,42
32,2014,857,22,12,21,55
32,2015,492,11,5,3,19
32,2016,540,16,7,11,34
32,2017,547,8,4,13,25
32,2018,553,14,5,19,38
32,2019,739,40,19,14,73
32,2020,765,19,17,16,52
32,2021,446,27,18,12,57
32,2022,431,26,16,9,51
32,2023,436,22,11,10,43
33,2006,473,26,5,8,39
33,2007,381,24,1,3,28
33,2008,387,20,3,2,25
33,2009,393,12,0,6,18
33,2010,388,25,0,10,35
33,2011,309,9,3,7,19
33,2012,363,16,0,9,25
33,2013,382,24,4,0,28
33,2014,522,24,2,0,26
33,2015,290,11,14,0,25
33,2016,317,12,10,3,25
33,2017,354,6,9,3,18
33,2018,351,7,10,0,17
33,2019,337,9,16,1,26
33,2020,257,3,4,1,8
33,2021,185,9,4,1,14
33,2022,161,6,3,1,10
33,2023,148,8,4,0,12
34,2006,275,18,0,8,26
34,2007,318,13,2,2,17
34,2008,288,14,2,3,19
34,2009,267,13,0,2,15
34,2010,313,13,1,2,16
34,2011,305,5,3,2,10
34,2012,234,6,3,6,15
34,2013,334,12,0,6,18
34,2014,298,11,0,0,11
34,2015,224,17,3,7,27
34,2016,269,14,0,0,14
34,2017,288,9,4,0,13
34,2018,323,8,1,0,9
34,2019,292,11,9,1,21
34,2020,252,13,8,2,23
34,2021,188,11,8,3,22
34,2022,189,14,3,3,20
34,2023,193,12,7,2,21
35,2006,1596,37,12,21,70
35,2007,1657,30,14,19,63
35,2008,1555,30,9,20,59
35,2009,1710,13,18,22,53
35,2010,1652,26,24,16,66
35,2011,1704,26,15,17,58
35,2012,1636,26,19,14,59
35,2013,1477,24,19,6,49
35,2014,1118,9,0,13,22
35,2015,718,5,0,9,14
35,2016,602,6,0,6,12
35,2017,772,6,3,6,15
35,2018,707,6,3,5,14
35,2019,776,11,7,14,32
35,2020,775,12,6,11,29
35,2021,293,9,5,4,18
35,2022,655,38,18,12,68
35,2023,709,37,11,13,61
36,2006,1142,19,4,52,75
36,2007,1206,23,4,26,53
36,2008,1121,7,3,22,32
36,2009,1040,4,2,35,41
36,2010,969,7,0,9,16
36,2011,901,8,0,27,35
36,2012,890,7,0,30,37
36,2013,850,9,2,15,26
36,2014,717,4,2,24,30
36,2015,508,2,2,12,16
36,2016,479,7,1,6,14
36,2017,483,0,0,3,3
36,2018,510,3,0,8,11
36,2019,540,1,0,9,10
36,2020,571,3,2,13,18
36,2021,151,5,1,2,8
36,2022,130,5,2,2,9
36,2023,288,12,4,5,21
37,2006,1114,20,11,37,68
37,2007,1186,12,10,37,59
37,2008,1137,21,7,22,50
37,2009,1113,10,9,12,31
37,2010,1100,19,8,18,45
37,2011,1062,18,9,21,48
37,2012,1011,16,5,19,40
37,2013,1083,13,12,15,40
37,2014,869,18,7,19,44
37,2015,646,7,5,6,18
37,2016,458,2,2,11,15
37,2017,531,5,1,14,20
37,2018,445,2,3,19,24
37,2019,475,3,4,17,24
37,2020,275,9,4,8,21
37,2021,205,7,2,2,11
37,2022,188,11,5,2,18
37,2023,267,19,4,4,27
38,2006,2336,53,25,42,120
38,2007,2482,37,25,23,85
38,2008,2385,46,17,19,82
38,2009,2196,45,13,20,78
38,2010,2271,42,23,24,89
38,2011,2122,43,23,20,86
38,2012,2187,41,22,14,77
38,2013,2163,53,26,12,91
38,2014,2283,29,16,24,69
38,2015,1136,9,9,6,24
38,2016,1000,8,7,8,23
38,2017,958,13,8,13,34
38,2018,870,10,7,19,36
38,2019,1015,8,11,22,41
38,2020,1022,11,13,14,38
38,2021,386,14,5,8,27
38,2022,763,35,16,12,63
38,2023,786,36,14,12,62
39,2006,2173,49,19,25,93
39,2007,2051,51,19,56,126
39,2008,2069,28,13,76,117
39,2009,2111,42,20,30,92
39,2010,2014,39,21,36,96
39,2011,1856,44,21,75,140
39,2012,1875,39,23,46,108
39,2013,2060,32,28,49,109
39,2014,1836,42,16,23,81
39,2015,1378,32,19,7,58
39,2016,1295,20,24,25,69
39,2017,1134,15,2,40,57
39,2018,1053,10,0,10,20
39,2019,1004,15,7,24,46
39,2020,1199,18,11,21,50
39,2021,492,21,8,11,40
39,2022,611,30,20,14,64
39,2023,656,27,19,12,58
40,2006,3558,89,34,35,158
40,2007,3597,78,25,22,125
40,2008,3575,57,18,36,111
40,2009,3462,69,22,18,109
40,2010,3435,78,32,39,149
40,2011,3432,69,35,46,150
40,2012,3471,51,26,30,107
40,2013,3445,52,17,44,113
40,2014,3012,36,16,41,93
40,2015,1336,3,5,19,27
40,2016,1125,0,9,18,27
40,2017,1256,3,6,15,24
40,2018,1241,4,2,24,30
40,2019,1208,5,5,22,32
40,2020,548,17,2,1,20
40,2021,421,16,5,9,30
40,2022,435,17,8,9,34
40,2023,602,21,20,10,51
41,2006,4133,65,28,153,246
41,2007,4088,47,24,83,154
41,2008,4032,45,23,86,154
41,2009,4065,41,22,82,145
41,2010,4382,57,21,138,216
41,2011,4397,44,44,79,167
41,2012,4297,39,36,77,152
41,2013,4352,35,32,125,192
41,2014,3657,16,17,74,107
41,2015,2618,20,19,34,73
41,2016,2439,17,15,72,104
41,2017,1847,1,0,45,46
41,2018,1629,2,0,51,53
41,2019,1926,1,1,45,47
41,2020,776,18,13,13,44
41,2021,694,27,9,22,58
41,2022,958,40,14,24,78
41,2023,900,46,15,32,93
42,2006,3049,46,19,164,229
42,2007,2830,10,10,110,130
42,2008,2709,17,7,117,141
42,2009,2757,19,12,137,168
42,2010,2693,19,7,157,183
42,2011,2628,21,7,162,190
42,2012,2627,13,9,112,134
42,2013,2721,13,9,130,152
42,2014,2620,18,10,105,133
42,2015,2071,17,9,63,89
42,2016,1480,9,5,56,70
42,2017,1220,0,0,74,74
42,2018,1091,0,0,53,53
42,2019,1328,2,0,71,73
42,2020,615,23,8,27,58
42,2021,530,18,8,18,44
42,2022,457,14,6,15,35
42,2023,655,25,17,26,68
46,2006,796,11,18,17,46
46,2007,829,21,6,8,35
46,2008,784,24,11,22,57
46,2009,742,19,4,13,36
46,2010,694,9,6,16,31
46,2011,587,12,2,16,30
46,2012,680,13,1,12,26
46,2013,592,15,0,12,27
46,2014,624,7,3,8,18
46,2015,560,11,4,30,45
46,2016,507,8,2,0,10
46,2017,564,8,4,4,16
46,2018,626,11,9,0,20
46,2019,592,12,4,12,28
46,2020,581,11,8,10,29
46,2021,404,14,7,2,23
46,2022,359,17,8,2,27
46,2023,327,12,7,4,23
47,2006,2666,26,13,77,116
47,2007,2527,36,15,55,106
47,2008,2658,35,16,77,128
47,2009,2561,36,19,57,112
47,2010,2793,46,13,104,163
47,2011,2821,47,13,119,179
47,2012,2954,46,16,83,145
47,2013,2883,32,23,54,109
47,2014,2669,15,15,72,102
47,2015,2033,6,2,48,56
47,2016,1744,0,0,26,26
47,2017,1563,1,0,35,36
47,2018,1468,1,0,46,47
47,2019,1588,0,0,45,45
47,2020,804,13,15,9,37
47,2021,1012,41,14,13,68
47,2022,852,22,13,15,50
47,2023,835,19,12,16,47
48,2006,219,15,9,3,27
48,2007,629,12,14,6,32
48,2008,803,11,9,6,26
48,2009,1007,16,18,10,44
48,2010,1059,36,21,18,75
48,2011,1182,37,11,6,54
48,2012,1112,42,13,5,60
48,2013,948,35,11,7,53
48,2014,1229,44,15,9,68
48,2015,1100,52,14,13,79
48,2016,1263,43,12,4,59
48,2017,1211,35,15,3,53
48,2018,1318,39,18,7,64
48,2019,1236,34,20,4,58
48,2020,789,24,13,3,40
48,2021,674,23,9,5,37
48,2022,662,20,11,5,36
48,2023,613,17,7,0,24
49,2006,2517,53,24,77,154
49,2007,2607,49,16,53,118
49,2008,2650,49,33,90,172
49,2009,2770,66,23,84,173
49,2010,2933,64,40,64,168
49,2011,2864,58,35,82,175
49,2012,2812,55,21,89,165
49,2013,2912,55,38,42,135
49,2014,2955,66,26,89,181
49,2015,2870,24,12,92,128
49,2016,2623,18,13,67,98
49,2017,2777,15,6,77,98
49,2018,2576,21,8,78,107
49,2019,2480,10,9,89,108
49,2020,2274,18,6,75,99
49,2021,1244,38,15,21,74
49,2022,1185,38,11,17,66
49,2023,1219,39,14,24,77
50,2006,2251,72,40,31,143
50,2007,2376,58,24,48,130
50,2008,2592,45,24,67,136
50,2009,2389,50,31,62,143
50,2010,2240,67,20,37,124
50,2011,2131,43,27,57,127
50,2012,1966,43,22,43,108
50,2013,1947,31,25,30,86
50,2014,2056,48,25,33,106
50,2015,1767,22,9,26,57
50,2016,1734,27,9,38,74
50,2017,1816,25,19,49,93
50,2018,1676,33,15,42,90
50,2019,1789,24,15,38,77
50,2020,1527,10,4,40,54
50,2021,376,8,4,8,20
50,2022,284,10,1,2,13
50,2023,311,9,4,4,17
53,2006,975,25,11,30,66
53,2007,987,16,13,54,83
53,2008,1013,13,10,37,60
53,2009,1060,18,9,25,52
53,2010,1128,29,13,38,80
53,2011,1068,15,8,33,56
53,2012,1064,21,13,17,51
53,2013,1108,16,15,25,56
53,2014,1161,28,9,31,68
53,2015,1158,40,14,28,82
53,2016,1140,25,3,29,57
53,2017,1248,32,6,48,86
53,2018,1192,26,23,34,83
53,2019,1326,26,13,30,69
53,2020,1266,31,14,27,72
53,2021,638,15,12,8,35
53,2022,508,17,6,7,30
53,2023,541,18,4,11,33
54,2006,1554,45,11,31,87
54,2007,1571,56,18,43,117
54,2008,1610,45,12,33,90
54,2009,1551,46,11,30,87
54,2010,1599,60,21,38,119
54,2011,1650,50,9,38,97
54,2012,1584,53,17,30,100
54,2013,1612,59,19,22,100
54,2014,1803,58,43,22,123
54,2015,2033,74,31,68,173
54,2016,1981,63,20,15,98
54,2017,2145,63,31,48,142
54,2018,2255,73,23,32,128
54,2019,2215,62,29,34,125
54,2020,1445,17,6,13,36
54,2021,799,21,7,3,31
54,2022,650,16,2,2,20
54,2023,682,21,7,4,32
56,2006,1370,30,4,62,96
56,2007,1348,30,13,60,103
56,2008,1396,26,12,40,78
56,2009,1538,38,20,38,96
56,2010,1630,57,9,65,131
56,2011,1660,31,17,51,99
56,2012,1680,39,12,64,115
56,2013,1619,30,14,66,110
56,2014,1608,26,8,61,95
56,2015,1712,22,15,47,84
56,2016,1576,26,9,33,68
56,2017,1687,37,15,42,94
56,2018,1711,30,10,62,102
56,2019,1734,38,12,53,103
56,2020,1553,29,5,42,76
56,2021,1030,28,9,17,54
56,2022,871,24,9,15,48
56,2023,861,23,5,9,37
57,2006,57,9,1,1,11
57,2007,159,8,1,0,9
57,2008,319,10,3,1,14
57,2009,342,10,6,0,16
57,2010,430,18,4,4,26
57,2011,755,24,11,11,46
57,2012,743,26,14,19,59
57,2013,701,17,6,4,27
57,2014,739,18,11,9,38
57,2015,548,17,8,5,30
57,2016,625,11,6,9,26
57,2017,639,14,6,5,25
57,2018,661,11,6,9,26
57,2019,663,17,8,11,36
57,2020,600,20,9,3,32
57,2021,529,16,9,8,33
57,2022,395,13,4,4,21
57,2023,333,6,8,7,21
58,2006,59,0,0,2,2
58,2007,64,0,0,0,0
58,2008,51,0,0,2,2
58,2009,54,0,0,0,0
58,2010,96,0,0,0,0
58,2011,69,0,0,0,0
58,2012,87,0,0,0,0
58,2013,139,0,0,2,2
58,2014,96,0,0,0,0
58,2015,138,0,0,8,8
58,2016,89,0,0,0,0
58,2017,209,0,0,0,0
58,2018,157,0,0,5,5
58,2019,170,0,0,5,5
58,2020,206,0,0,2,2
58,2021,55,0,0,1,1
58,2022,63,0,0,2,2
58,2023,101,1,0,1,2
59,2019,10,0,0,0,0
59,2020,13,0,0,0,0
59,2021,8,0,0,0,0
59,2022,6,0,0,0,0
59,2023,7,0,0,0,0
60,2006,1549,20,8,57,85
60,2007,1610,17,10,53,80
60,2008,1938,33,13,49,95
60,2009,2141,45,27,76,148
60,2010,2412,46,13,62,121
60,2011,2312,45,19,78,142
60,2012,2396,45,14,49,108
60,2013,2446,36,4,52,92
60,2014,2424,24,13,47,84
60,2015,2241,35,12,40,87
60,2016,2313,13,5,47,65
60,2017,2355,17,18,42,77
60,2018,2273,24,18,44,86
60,2019,2350,35,14,53,102
60,2020,2227,19,15,36,70
60,2021,997,22,9,13,44
60,2022,1013,33,7,10,50
60,2023,1098,31,7,15,53
61,2006,958,24,3,17,44
61,2007,981,21,9,20,50
61,2008,1203,27,14,31,72
61,2009,1251,19,7,18,44
61,2010,1451,37,10,34,81
61,2011,1415,31,10,13,54
61,2012,1461,38,12,13,63
61,2013,1461,20,12,31,63
61,2014,1360,21,14,24,59
61,2015,1335,16,7,23,46
61,2016,1337,19,5,10,34
61,2017,1492,12,6,26,44
61,2018,1480,16,9,32,57
61,2019,1556,14,7,37,58
61,2020,1453,21,6,17,44
61,2021,585,16,5,9,30
61,2022,458,9,3,5,17
61,2023,455,7,1,11,19
62,2006,117,3,0,9,12
62,2007,154,5,0,6,11
62,2008,222,3,0,0,3
62,2009,199,1,0,0,1
62,2010,242,4,0,2,6
62,2011,257,0,0,2,2
62,2012,257,4,0,2,6
62,2013,270,4,0,2,6
62,2014,275,5,0,6,11
62,2015,308,0,0,6,6
62,2016,315,7,0,0,7
62,2017,336,3,0,11,14
62,2018,338,2,1,8,11
62,2019,399,0,0,9,9
62,2020,406,1,0,5,6
62,2021,57,1,0,0,1
62,2022,139,8,1,1,10
62,2023,182,2,1,1,4
63,2006,589,4,0,11,15
63,2007,696,5,3,11,19
63,2008,730,9,5,2,16
63,2009,881,16,9,21,46
63,2010,984,4,4,25,33
63,2011,916,12,7,25,44
63,2012,950,8,6,12,26
63,2013,1106,7,7,4,18
63,2014,923,4,3,0,7
63,2015,1088,14,13,9,36
63,2016,1047,13,1,9,23
63,2017,1210,8,4,4,16
63,2018,1207,16,5,18,39
63,2019,1256,15,5,13,33
63,2020,1080,6,0,14,20
63,2021,392,12,2,1,15
63,2022,391,13,1,2,16
63,2023,416,13,4,1,18
65,2006,64,8,6,4,18
65,2007,49,9,0,0,9
65,2008,43,5,2,0,7
65,2009,47,5,2,0,7
65,2010,88,5,3,0,8
65,2011,80,4,5,3,12
65,2012,73,5,4,1,10
65,2013,101,8,5,1,14
65,2014,125,9,8,0,17
65,2015,109,3,2,0,5
65,2016,207,7,3,1,11
65,2017,255,7,2,4,13
65,2018,205,4,3,0,7
65,2019,249,14,4,2,20
65,2020,258,11,9,1,21
65,2021,197,8,3,0,11
65,2022,187,6,0,0,6
65,2023,190,4,4,1,9
1,2006,2,0,0,0,0
1,2007,4,0,0,0,0
1,2008,13,0,0,0,0
1,2009,28,0,0,0,0
1,2010,0,0,0,0,0
1,2011,1,0,0,0,0
1,2012,13,2,0,0,2
1,2013,13,0,0,0,0
1,2014,9,0,0,2,2
1,2015,4,0,0,0,0
1,2016,9,2,0,0,2
1,2017,17,0,0,0,0
1,2018,9,0,0,0,0
1,2019,36,0,0,0,0
1,2020,50,0,0,0,0
1,2021,16,0,0,0,0
1,2022,22,0,0,0,0
1,2023,24,0,0,3,3
1,2006,132,24,5,2,31
1,2007,166,20,5,0,25
1,2008,191,21,6,2,29
1,2009,161,15,4,2,21
1,2010,164,20,7,8,35
1,2011,128,19,3,3,25
1,2012,160,30,10,3,43
1,2013,191,21,4,4,29
1,2014,198,31,3,2,36
1,2015,259,26,4,0,30
1,2016,282,35,6,0,41
1,2017,319,29,0,0,29
1,2018,399,33,2,0,35
1,2019,381,36,3,1,40
1,2020,336,34,1,0,35
1,2021,328,37,4,1,42
1,2022,250,34,6,0,40
1,2023,300,47,6,0,53
1,2006,1,0,0,0,0
1,2007,3,0,0,0,0
1,2008,8,3,0,0,3
1,2009,19,3,0,0,3
1,2010,34,1,2,2,5
1,2011,47,2,1,0,3
1,2012,31,4,0,3,7
1,2013,24,2,0,0,2
1,2014,11,2,0,0,2
1,2015,43,9,4,0,13
1,2016,24,6,0,0,6
1,2017,46,6,0,0,6
1,2018,47,8,1,0,9
1,2019,55,7,2,0,9
1,2020,107,8,0,0,8
1,2021,85,11,1,0,12
1,2022,86,9,1,0,10
1,2023,76,10,0,0,10
7,2006,36,5,1,2,8
7,2007,29,2,3,0,5
7,2008,37,2,0,0,2
7,2009,20,2,0,0,2
7,2010,17,0,0,0,0
7,2011,15,0,0,0,0
7,2012,12,0,0,0,0
7,2013,7,0,0,0,0
7,2014,6,0,0,0,0
7,2015,0,0,0,0,0
7,2016,5,0,0,0,0
7,2017,4,0,0,0,0
7,2018,0,0,0,0,0
7,2019,5,0,0,0,0
7,2020,2,0,0,0,0
7,2021,0,0,0,0,0
7,2022,0,0,0,0,0
7,2023,0,0,0,0,0
7,2006,348,11,1,16,28
7,2007,292,13,3,6,22
7,2008,344,7,1,5,13
7,2009,250,1,1,2,4
7,2010,303,4,3,0,7
7,2011,207,4,3,0,7
7,2012,134,5,0,0,5
7,2013,164,0,0,0,0
7,2014,100,0,2,1,3
7,2015,66,5,0,0,5
7,2016,38,0,0,0,0
7,2017,23,0,0,0,0
7,2018,23,0,0,0,0
7,2019,32,0,0,0,0
7,2020,31,0,0,0,0
7,2021,3,1,0,0,1
7,2022,8,0,0,0,0
7,2023,17,0,0,0,0
9,2006,623,43,13,27,83
9,2007,747,55,16,15,86
9,2008,733,49,15,11,75
9,2009,634,20,10,29,59
9,2010,545,22,13,26,61
9,2011,581,36,8,9,53
9,2012,470,28,14,5,47
9,2013,510,24,4,0,28
9,2014,570,32,13,4,49
9,2015,493,32,8,0,40
9,2016,466,24,15,3,42
9,2017,419,17,13,8,38
9,2018,265,9,3,0,12
9,2019,231,7,5,4,16
9,2020,231,7,7,7,21
9,2021,78,6,2,1,9
9,2022,85,8,4,1,13
9,2023,86,5,3,3,11
9,2006,476,31,13,25,69
9,2007,475,26,6,16,48
9,2008,472,15,6,5,26
9,2009,519,18,6,13,37
9,2010,472,14,6,31,51
9,2011,431,18,7,9,34
9,2012,404,13,7,16,36
9,2013,409,14,5,0,19
9,2014,306,10,7,3,20
9,2015,284,11,3,0,14
9,2016,189,6,3,0,9
9,2017,270,22,4,3,29
9,2018,199,2,2,0,4
9,2019,206,6,5,4,15
9,2020,182,7,8,2,17
9,2021,81,6,1,0,7
9,2022,60,5,2,2,9
9,2023,61,5,4,2,11
11,2006,333,21,4,24,49
11,2007,394,13,11,10,34
11,2008,389,24,2,2,28
11,2009,365,21,3,2,26
11,2010,291,20,2,14,36
11,2011,400,18,2,8,28
11,2012,294,17,3,8,28
11,2013,306,18,3,0,21
11,2014,246,4,10,0,14
11,2015,242,14,7,2,23
11,2016,234,21,9,3,33
11,2017,200,4,8,9,21
11,2018,144,8,3,0,11
11,2019,171,9,4,3,16
11,2020,193,9,6,4,19
11,2021,107,12,3,0,15
11,2022,106,8,4,1,13
11,2023,228,21,6,9,36
11,2006,634,52,13,0,65
11,2007,664,45,14,9,68
11,2008,598,42,16,2,60
11,2009,538,28,9,8,45
11,2010,505,30,14,12,56
11,2011,494,35,13,7,55
11,2012,534,35,12,4,51
11,2013,527,29,5,10,44
11,2014,425,8,14,3,25
11,2015,309,16,13,0,29
11,2016,358,20,13,0,33
11,2017,371,7,15,8,30
11,2018,404,16,13,5,34
11,2019,267,11,11,1,23
11,2020,270,14,2,0,16
11,2021,193,10,8,1,19
11,2022,152,10,5,2,17
11,2023,155,6,2,3,11
12,2006,834,55,12,17,84
12,2007,735,62,19,25,106
12,2008,757,52,13,16,81
12,2009,732,33,8,13,54
12,2010,709,57,10,39,106
12,2011,643,48,12,2,62
12,2012,598,63,12,0,75
12,2013,774,45,14,13,72
12,2014,595,17,19,7,43
12,2015,659,42,14,0,56
12,2016,547,24,22,3,49
12,2017,590,26,12,7,45
12,2018,384,9,9,4,22
12,2019,446,22,9,5,36
12,2020,442,20,11,5,36
12,2021,270,21,14,5,40
12,2022,224,14,7,4,25
12,2023,265,18,10,7,35
12,2006,1775,105,59,112,276
12,2007,1663,123,44,67,234
12,2008,1494,99,43,9,151
12,2009,1641,64,42,26,132
12,2010,1646,96,35,60,191
12,2011,1555,98,39,27,164
12,2012,1534,107,40,59,206
12,2013,1406,82,25,48,155
12,2014,1469,101,38,30,169
12,2015,1286,82,28,29,139
12,2016,1131,65,46,6,117
12,2017,1134,50,35,13,98
12,2018,1195,52,31,9,92
12,2019,1126,55,38,21,114
12,2020,1140,50,36,12,98
12,2021,777,66,40,14,120
12,2022,738,58,18,16,92
12,2023,498,29,11,8,48
15,2006,1194,100,28,36,164
15,2007,1194,103,41,57,201
15,2008,1299,67,26,42,135
15,2009,1257,52,30,63,145
15,2010,1201,66,29,45,140
15,2011,1156,94,30,29,153
15,2012,1244,89,43,16,148
15,2013,1475,80,31,35,146
15,2014,1441,61,53,26,140
15,2015,1064,42,26,0,68
15,2016,1046,56,40,9,105
15,2017,1035,48,35,11,94
15,2018,984,33,33,4,70
15,2019,960,51,31,8,90
15,2020,981,46,26,2,74
15,2021,903,68,59,16,143
15,2022,823,43,28,9,80
15,2023,867,45,25,11,81
15,2006,4297,275,82,73,430
15,2007,3843,246,78,41,365
15,2008,3717,227,69,28,324
15,2009,3898,149,49,16,214
15,2010,3690,203,116,38,357
15,2011,3619,216,98,68,382
15,2012,3633,239,115,37,391
15,2013,3321,213,72,36,321
15,2014,2827,109,69,35,213
15,2015,2883,144,68,6,218
15,2016,2396,94,64,13,171
15,2017,2459,97,76,11,184
15,2018,2159,62,63,10,135
15,2019,2555,128,93,5,226
15,2020,2736,101,73,5,179
15,2021,2780,155,118,21,294
15,2022,2722,122,78,19,219
15,2023,2692,122,64,17,203
16,2006,100,15,4,1,20
16,2007,150,18,0,0,18
16,2008,153,25,2,2,29
16,2009,197,17,4,2,23
16,2010,302,40,11,6,57
16,2011,314,37,10,6,53
16,2012,335,24,6,8,38
16,2013,292,33,5,4,42
16,2014,400,20,13,14,47
16,2015,422,29,5,0,34
16,2016,423,29,4,0,33
16,2017,393,16,6,0,22
16,2018,361,27,7,0,34
16,2019,403,21,13,1,35
16,2020,324,32,2,0,34
16,2021,309,32,7,0,39
16,2022,286,30,9,0,39
16,2023,299,35,8,1,44
16,2006,333,35,9,9,53
16,2007,348,47,6,2,55
16,2008,359,41,11,6,58
16,2009,448,43,2,8,53
16,2010,370,41,9,10,60
16,2011,377,47,11,7,65
16,2012,421,36,4,3,43
16,2013,408,25,8,0,33
16,2014,406,13,12,8,33
16,2015,430,43,14,3,60
16,2016,497,34,7,0,41
16,2017,561,35,15,2,52
16,2018,567,41,7,3,51
16,2019,668,52,23,0,75
16,2020,769,43,20,1,64
16,2021,697,41,14,3,58
16,2022,585,30,15,3,48
16,2023,551,44,10,2,56
16,2006,482,24,7,6,37
16,2007,495,41,8,0,49
16,2008,451,33,10,0,43
16,2009,398,23,10,0,33
16,2010,380,27,7,7,41
16,2011,392,27,6,2,35
16,2012,362,19,9,2,30
16,2013,350,30,6,2,38
16,2014,431,38,9,0,47
16,2015,343,15,0,0,15
16,2016,290,23,4,2,29
16,2017,318,21,11,0,32
16,2018,315,10,5,0,15
16,2019,245,11,6,0,17
16,2020,270,21,2,0,23
16,2021,316,24,8,1,33
16,2022,291,31,8,8,47
16,2023,309,26,5,3,34
18,2006,660,40,3,4,47
18,2007,686,39,3,1,43
18,2008,743,30,5,4,39
18,2009,691,22,14,3,39
18,2010,702,34,15,3,52
18,2011,757,23,9,3,35
18,2012,845,24,11,13,48
18,2013,910,22,14,2,38
18,2014,947,33,15,9,57
18,2015,960,34,15,0,49
18,2016,922,30,5,1,36
18,2017,1009,19,15,0,34
18,2018,1054,17,9,3,29
18,2019,935,17,11,2,30
18,2020,1031,22,13,1,36
18,2021,964,27,13,6,46
18,2022,895,21,11,4,36
18,2023,203,6,2,1,9
18,2006,269,4,2,0,6
18,2007,306,20,1,2,23
18,2008,368,6,4,0,10
18,2009,326,16,2,5,23
18,2010,327,23,9,0,32
18,2011,352,14,10,0,24
18,2012,294,22,4,0,26
18,2013,271,16,4,0,20
18,2014,292,14,1,0,15
18,2015,292,13,4,0,17
18,2016,339,6,0,0,6
18,2017,337,10,2,0,12
18,2018,355,8,6,0,14
18,2019,398,10,12,0,22
18,2020,404,8,4,0,12
18,2021,334,13,9,1,23
18,2022,304,10,8,1,19
18,2023,172,2,4,1,7
21,2006,3469,204,47,19,270
21,2007,4119,167,63,34,264
21,2008,4173,112,52,34,198
21,2009,4110,116,68,33,217
21,2010,4178,109,117,24,250
21,2011,4191,118,125,42,285
21,2012,4025,102,85,20,207
21,2013,3740,115,64,18,197
21,2014,4419,76,102,44,222
21,2015,3083,82,61,0,143
21,2016,3055,66,44,3,113
21,2017,2937,68,49,3,120
21,2018,2639,44,36,4,84
21,2019,2591,99,59,4,162
21,2020,2348,57,31,0,88
21,2021,1920,71,49,11,131
21,2022,1685,45,26,10,81
21,2023,1586,52,34,6,92
21,2006,2968,148,39,52,239
21,2007,2477,107,40,39,186
21,2008,2207,101,33,22,156
21,2009,2211,82,33,23,138
21,2010,2216,93,40,36,169
21,2011,2423,142,34,13,189
21,2012,2345,129,38,48,215
21,2013,2448,128,52,32,212
21,2014,2763,131,52,32,215
21,2015,2768,93,61,13,167
21,2016,2404,66,61,2,129
21,2017,2665,84,49,9,142
21,2018,2845,76,63,20,159
21,2019,2782,102,86,12,200
21,2020,2033,56,30,2,88
21,2021,1537,64,48,9,121
21,2022,1361,51,34,4,89
21,2023,1342,60,36,14,110
55,2006,68,4,1,0,5
55,2007,187,8,5,3,16
55,2008,334,18,2,2,22
55,2009,329,10,2,2,14
55,2010,356,14,8,0,22
55,2011,518,17,7,16,40
55,2012,633,20,9,16,45
55,2013,598,14,4,3,21
55,2014,582,17,9,6,32
55,2015,590,11,15,6,32
55,2016,604,14,7,5,26
55,2017,641,15,8,5,28
55,2018,644,20,6,7,33
55,2019,695,15,10,6,31
55,2020,322,9,2,1,12
55,2021,182,9,1,1,11
55,2022,146,4,1,2,7
55,2023,175,4,2,0,6
55,2006,17,5,0,0,5
55,2007,85,6,2,0,8
55,2008,145,4,4,0,8
55,2009,145,3,5,0,8
55,2010,146,3,5,0,8
55,2011,110,6,2,0,8
55,2012,103,4,2,0,6
55,2013,150,4,4,0,8
55,2014,128,3,2,0,5
55,2015,118,0,2,0,2
55,2016,125,3,0,0,3
55,2017,145,4,0,1,5
55,2018,241,7,4,1,12
55,2019,266,8,5,2,15
55,2020,197,4,4,1,9
55,2021,123,6,1,0,7
55,2022,107,1,1,0,2
55,2023,112,1,3,0,4
